#############################################################################
                                                                          X #
#########################################################################   #
    #            #    #                              #             #        #
           #          #    ##### # # #########       #             #        #
######  ####### ##    #      #       #           #   #      #    ###        #
         #       #    # ######    ###  #    ## ## #######          #####    #
  #           F  #           #       #    ####     #        ###    #        #
##### ################ ##########    #       #     #     #  #      #        #
            #     #      #   #                     #####    #      #   S    #
            #            #           #       #              #               #
#############################################################################
